################################↑#################
#  #   #    #   #  #           # # #   #    #  # #
#  #   #    #   #  #           # # #        #  # #
#  #   #    #   #  #           # # #   #    #  # #
#  #   #    #   #  ## ########## # #   #    #  # #
#  #   #    #   #  #    #    # # # #   #    #  # #
#  #   #    #   #       #    # # # #   #    #  # #
#  #   #    #   #  #    #    # #   #   #    #  # #
#  #   #    #   #  #    #    #   # #   #    #  # #
#  #   #    #   #  #    #      # #     #    #  # #
#  #   #    #   #  #    #    # # # #   #       # #
#  #   #    #   #  #    ###### # #### ##    #  # #
#  #   #        #  #           # #     #    #  # #
#  #   #    #   #  #    #      # ######## ###  # #
#  #   #    #   #  #    #      # #          #  # #
#  #   #    #   ########### ########## ######  # #
#  #   #    #   #              #            #  # #
#  #   #    #   ############## ##############  # #
#  #   #    #   #                           #  # #
#  #   #    #   #                           #  # #
#  #   #    #   #                           #  # #
#  #   #    #   ### ############################ #
#  #   #    #   #   #                          # #
#  #   #    #   #   #                          # #
#  #   #    #   #   #                          # #
#  #   #    #   #   #                          # #
#  #   #    #   #   ############# ############## #
#  #   #    #   #   #                   #      # #
#  #   #    #       ######## ############ #    # #
#  #   #    #   #   #               #   # #    # #
#           #   #   ## ##############     #    # #
#  #   #    #   #   #               #   # #    # #
#  #   #    #   #   #   #           #   #### ### #
#  #   #    #   #       ######## ####   #        #
#  #   #    #   #   #   #           #   #      # #
#  ## #######   #   #   #           #   #      # #
#  #        #   #   #   #               #      # #
#  #        ## ################################# #
#  #        #             #                    # #
#  #        #                  #               # #
# ####################### #    #               # #
#  #      # #       #     #    ############## ## #
#  #      # #### ####     #    #               # #
#  #      # #       ### ################# ###### #
#           #             #                    # #
#  # ###### #       #     #                    # #
#  #      # ####### ##############################
#  ##### ####                                    #
#  #        #                                    #
##################################################
