##################################################
#   # #   #     #          #             #       #
#   # #   ##### #          ######## ######       #
#   # #   #     ####### ####             ### #####
#   # #   #     #          ###### #        #     #
#   #     #                #      #      # #### ##
#   # #   ############### ##      ### #### #     ↓
↑   # #                    #      #      #       #
#   ### ###                #      #      # #     #
#   #     #                #################### ##
#   ####### ################   #     #     #     #
#   # #                    #   #### ##  #  #     #
#   # # #                  #   # #   #  #  ##### #
#   # # ### ################     #   #  #  #   # #
#   # # #         #        #   # #   #  #      # #
#   # # ######### ## #######   # #   #  #  #   # #
#   #   #                  #   # #   #  #  #   # #
#   # # #         #        #   # #   #  #  #   # #
#   # # #         #        #   # #   #  #  #   # #
#   # # #         #        #   # #   #  #  #   # #
#   # ################### ##   #     #  #  #   # #
#   # #        #  #  # #   ### #######  #  #   # #
#   # #           #  # #     #   # # #  #  #   # #
#   # ######## #     #     # #   # # #  #  #   # #
#   # #        #  #  # #   # #   # # #  #  #   # #
#   # # ###### #  #  # #   # #     # #  #  #   # #
#   # # #    # ## #### #   # #   #   # #####   # #
#   # #      # #     # #   # #   # # #     #   # #
#   # # #    # #     ##### # #   # # #     #     #
#   # # #    # #     #     # #   # # #     #   # #
#   # # #    # #           # ### ### #     #   # #
#   # # #    # ######### ###       # #### ########
#     # #    # #           # #     # #         # #
##################### ###### #     # #         # #
#        #  #          #   # #     # #### ###### #
#        #             #   ####### # # #     # # #
## #######  #          #   #   #   # # #     # # #
#        #  ######### ##   #   #   # # #     # # #
#           #       #  #   #   #   # # #     # # #
#        #  ###### ##      #   #   # # ## #### # #
#### ########   #   #  #   #   #   # # #   # # # #
#  #     #  #       #  #   #   #   # # #   #   # #
#  ### ###  #   #   #  #   #       # # #   # # # #
#  #     #  #   #   #  #   #   #   #   #     # # #
#        #  #   #      #   #   #   # #     # # # #
#  #        #   #   #  #   #   #   # # #   # #   #
######## #  ##### ##########   #   # # ### ##### #
#        #  #              #   #   # # #       # #
#        #  #              #   #   # # #       # #
##################################################
