##################################################
#   #            # #                         #   #
#   #            # #                         #   #
#   #              ############## ############   #
#   #            # #    #  # #     #    #    #   #
#   ###### ####### #    #  # # #####    #    #   #
#              # # #    #  #       #         #   #
#   #          # # #    #  # #     #    #    #   #
#   #            # #         #     #    #    #   #
#   #### ####### # ####### ##### ###    #    #   #
#   #          # # #       #       #    #    #   #
#   ######### #################### #    #    #   #
#   #            # #               #    #    #   #
#   #              #   #           #    #    #   #
#   #            # #   #           #    #    #   #
#   #            # #   ########## ##    #    #   #
#   ###### ####### #   # #   # #   #    #    #   #
#   #            # #   # #     #   #    #    #   #
# ##################   # #   # #   #    #    #   #
# #              # #   # #   # #   #    #    #   #
# ############## # #   #     # #   #    #        #
# #              # #   # #   # #   #    #    #   #
#                  #   # ## ####        #    #   #
# #              #     # #     #   #    #    #   #
# ##### ############   ##### ###   #    #    #   #
# #       #        #   # #     #   #    #    #   #
# #                #   # #         #    #    #   #
# #       ## #######   #       #   ######### #   #
# # #######        #   # ##### #   #         #   #
# #       #        #   # #     #   #         #   #
################ #############################   #
#    #                                     # #   #
#    ############################# ######### #   #
#    #                                       #   #
#                                          # #   #
#    #                                     # #   #
############################### ############ #   #
#                                        # # #   #
#                    ################ #### # #   #
################# ####                   # # #   #
#                    #                   # # #   #
#                    #                   # # #   #
######### ################################ # #   #
#                                   #    # # #   #
#                                        # # #   #
############## ######################      # #   #
#                                   #    # # #   #
#                                   #    # # #   #
#                                   #    # # #   #
###############################################↓##
