##################################################
#       #  #                                     #
# # #####  #                                     #
# #   # #  #                                     #
# #   # #  #                                     #
↑ #   # #  ############################# #########
# #   # #  # #  #  # #                           #
# #   # #  # #  #  # #                           #
# #   # #  # #  #  # ####################### #####
# #   # #  # #  #  # #        #   #   # # #   #  #
# #   # #  # #  #  # ##### ####   #   # # #      #
# #   # #  # #  #  # #        #   #   #   #   #  #
# #   # #  # #  #  # # ##### ##   #   # # #   #  #
# #   # #  #    #    # #          #   # # #   #  #
# #   # #  # #     # # #      #   #   # #     #  #
# #   # #  # ## #### # #      #   #   # # #   #  #
# #   # #  # #   # # ############ #   # # #   #  #
# #   # #  # #   # #      #       #   # ### ###  #
# #   # #  # #   # # #            #   # #   # #  #
# #   # #  # #   # # #    #       #   # #   # #  #
# #   # #  # #     # #    #### ####   # #   # #  #
# #   # #  # #   # # #    #           # #   # #  #
# #   # #    #   # # ######## ######### #   # #  #
# #   # #  # #   # # #    #         # # #     #  #
# #   # #  # #   # # #    #         # # #   # #  #
# #   # #  # #   # # #    #### ###### # #   # #  #
# #   # #  # #   # # #    # #       # # #   # #  #
# #     #  # #   # # #    # ##### ### # #   # #  #
# #   # #  # #   # # #    #         # # #   # #  #
# #   # #  # ### #####    # #       # # #   # #  #
####### #  # #       #      #       # # ## #######
#  #  # #  # #       #    # #       # # #        #
#  #  # #  ######## ############ #### # #        #
#  #  # #  #     #   #            # # #### #######
#  #  # #  #     #   ## ###########   #          #
#  #  #    #         #            # # #          #
#     # #  #### ##   #            # # #          #
#  #  # #  #     #   #              #            #
#  #  # #################### #####################
#  #  # #                     #                  #
## #### ##################### #                  #
#   #   #                     ######## ###########
#   # # # ################### #            #     #
#   # # # #      #         #  ###### ########### #
#     # # #### ###         #  #      #     #     #
#   # # # #      #         #         #       #   #
#   # # #        #         #  #            # #   #
#   # # # #      ####### ###  #### ### ##### #   #
#   # # # #      #            #      #     # #   #
##################################################
