##########################################↑#######
#                    # #                 # #   # #
#          ######## ## ######## ########## #   # #
#          #         # #                 # #   # #
######### ##         # # ### ###### ###### #   # #
#          #           # #    # #      # # #   # #
################ ##### # #    # #      # # #     #
#                    # # #      #        #     # #
############# ########## #    # ## #####   #   # #
#                      # #    # #      # # #   # #
#                      # #    # #      # # #   # #
#                        ## ############## #   # #
#                      # #               # #   # #
###### ################################### #   # #
#      #                                 # #   # #
#### ######### ########################### #   # #
# #    # #          #   #                # #   # #
# #    # # ##########   # ###### ######### #   # #
# #    #            #   # #              # #   # #
# #    # #          #     #              # ##### #
# #    # #          #   # #              # #   # #
# #    # #          #   # #              # #   # #
# #    ############ #   #### ############# #   # #
# #    #            #   # #        # #   # #   # #
# #    #                # ####### ## #   # #     #
# #    #            #   # #   # #  # #   # #   # #
# #    ########### ###### #   # #  #     # #   # #
# #    #   # #       #  # #   # #  # #   # #   # #
# #        # #       #  # #   # #    #   # #######
#      #     ## ######  # #   # #  # #   #  #    #
# #    #   #      #  #  # #   # #  # #   #  #    #
# #    #   # #    #  #  # #     #  # #   #  #    #
# #    #   # #    #     # #   # #  # #####  #    #
# #    #   # #       #  # #   #    #   # #  #    #
# #    ## ####    #  #  # ## ####  #   # #  #    #
# #    #   # #    #  #  # #  #  #  #   # #  #    #
# #    #     #    #  #  # #  #  #  #     #  #    #
# #    #   # #    #  #  # #  #  #  #   # #       #
# #    #   # #    #  #  # #  #  #  #   # #  #    #
# #    #   # #    #  #  # #  #  #  #   # #  #    #
# #    #   # #    #  #  # #  #  #  #   # #  #    #
# #    #   # #    #  #  # #  #  #  #   # #  #    #
# #    #   # ####### #### #  #  #  #   # #  #    #
# #    #   # #        # # #  #  #  #   # #  #    #
# #    #   # #          #    #  #  #   # #  #    #
# #    #   # #        # # #     #  #   # #  #    #
# #    #   # #        # # #  #  #  #   # #  #    #
# #    #   # ######## # ###### #####   # #  #    #
# #    #   # #        # #          #   # #  #    #
#########↓########################################
