########################################↑#########
#                    #   #  #   # #            # #
############## #######   #  #   # #### ######### #
#   # #        #  #  #   #  #   # #      #     # #
#   # #        #  #  #   #  #   # #      #     # #
#   # #        #  #  #   #      # ### ##### #### #
#     ## #######  #  #      #     #            # #
#   # #    #   #     #   #  #   #        #     # #
#   # #    #   # #####   #  #   # #      #     # #
#   # #        # #   #   #  #   ########### #### #
#   # #    #   #     #   #  #   #              # #
#   # #    #   # #       #  #   #              # #
#   #      #   # #   #   #### ###              # #
#   ######### ## #   #   #      #              # #
#   #          # #   #   #################### ## #
#   #          # #   #   #       #             # #
#   #          # #   #   #### ####  ## ######### #
########### #### #   #   # #     #  #          # #
#                #   #   # #        #          # #
#     ## ####### #   #   # #     #  #          # #
### ###  #     # #   #   # #     ####### ####### #
# #   #    #   # #   #   # # #####       # #   # #
#     #  # #   # #   #   # # #   #       #     # #
# #   #  # #   # #   #   # # #   #         #   # #
# #   #  # #   # #   #   #   #   #       # #   # #
# #   #  # #   # #   #   # # #   ###### ## #   # #
# #   #  #### ## #   #   # # #   #    #  # #   # #
# #   #  #     # #   #   # # #   #    #  # #   # #
################### ###### # #   #    #  # #   # #
#   #                    # # #   #    #  # #   # #
#                        # #     #    #  # #   # #
#   #                    # # #   #    #  # #   # #
#   #################### # # #   #       ### ### #
#   #                    # # #   #    #  #     # #
####################### ######################## #
#                         #                 #  # #
#                         #                 #  # #
#                         #                      #
#                         #                 #  # #
################### ######## ################  # #
#                 #       #                 #  # #
# ################## ######                 #  # #
#           #     #     # ################ ##### #
#    ###### # ####### ### #                 #  # #
#    #      #     # #   # #                    # #
#    #      # #     #   # ###### ############  # #
#    #      # #   # #   # #                 #  # #
### ######### #   # #   #                   #  # #
#             #   #       #                 #  # #
##########↓#######################################
