##################################################
#   # #     #         # #     # #                #
#   # #     ##### ##### ### ### #                #
#   #       #         # #       ########### ######
#   # ##### #         #       # #      #    #    #
#   # #               # #     # # ######    #    #
#   # ## ############## ### #####      #    #    #
#   # #                 #       #    # #    #    #
#   ############ ############## #    # #    #    #
#   #               # #   #   # #    #      #    #
#   #               # #   #   # #    # #    #    #
#   #               # #   #   # ###### ######    #
#   ######### ####### #   #   # # # #     # #    #
#   # # #      #    # #   #   # # #       # #    #
#   # #             # #   #   # # # #     # #    #
#     # #      #      #   #   # # # #     # #    #
#   # # ### ####    # #   #   # # # # ##### #    #
#   # # #      #    # #   #   # # # #     # #    #
#   # ##### ####    # #   #   # # # #     # #    #
#   # #        #    # #   #   # # # #     # #    #
#   # ###### ######## #         # ###### ## #    #
#   #      #        # #   #   # # #   #   # #    #
↑   # #    # ######## #   ### ### #   #   #      #
#   # #    #        # #   #     # #   #   # #    #
#   # #    #        # #   #     # #   #   # #    #
#   # #    #        # #   #     # #   #   # #    #
#   # #             # #   #     # #   #   # #    #
#   ########### ################# #   #   # #    #
#   #         #    #            # #   #   # #    #
#   ###### ####    ####### ###### #   #   # #    #
#   # # #     #       #           #   #   # #    #
#   # # # #####    #  ## ######## #   #   # #    #
#   # # #     #    #            # #   #   # #    #
#   # #       #    #  #         # #   #   # #    #
#   # # #     #    #  #         # #   #   # #    #
#   # # #     ############# ##### #   #   # #    #
#   # #### ####    #   #    #   # #   #     #    #
#   # #     # #    #        #   # #   #   # #    #
#   # #### ## #    #   #    #   # #   #   # #    #
#   # #  #  # #    #   #    #   # #   #   # #    #
#   #    #  # #    #   #        #     #   # #    #
#   # #  #    #        #    #   # #   #   # #    #
#   # #  #  #      #   #### ##### #   #   # #    #
#   # #  #  # #    #   #        # #   #   # #    #
#   # #     # #    #   #        # #   #   # #    #
#   # #  #  # #    ######### #### #       # #    #
#   # #  #  # #    #            # #   #   # #    ↓
######## ######################## ## ########    #
#                               # #         #    #
##################################################
