##################################################
#                      # # #   #               # #
############ ######### # # #   #               # #
#                    # # # #   #               # #
#                    #   # #   #               # #
#                    # # # #   ####### ######### #
############## ######### # #   #     # #       # #
#    #    # #          # # #   #     # #       # #
#    #  #   ########## # #     #       #       # #
#    #  # # # # #      # # #   ##### # #       # #
#    #  # # # # # ###### # #   #  #  # ##### ### #
#    #  # # # # #  #   # # #   #  #  #         # #
#    #  # # # # #  #   # # #   #     # #         #
#    #  # # #   #  #   # # #   #  #  ### ####### #
#    #  # # # # #  #   # # #   #  #  #         # #
#    #  # # # # #  #   # # #   #  #  #         # #
#    #  # # # #        # # #   #  #  #         # #
#    #  # # # # #  #   # # #   ########## ########
#    #  # # # #### ##### # #   #          # #    #
#       # # # # #      # # #   ########## # #    #
#    #  # # # #        # # #   #  #     # # #    #
####### # # # # #      # # #   #  #     # # #    #
# #     # # # # #### ### # #   #  #     # # #    #
# #     # # # # #      # # #   #  #     # # #    ↓
# #     # # # # #  #   # # #   #  # ##### # #    #
# ## #### #   # #  #   # # #   #  # #   # # #    #
# #   # # # # # #  #   # # #   #  # #   #   #    #
# #     # # # # #  #   # ### ###  # #     # #    #
# #   # # ####### ###### # #   #  # #   # # #    #
#     # # #  #  #   #  # # #   #  # #   # # #    #
# #   # # #  #  #   #  # # #   #  #     # # #    #
# #   # # #     #   #  # # #   #  # #   # # #    #
# #   # # #  #  #   #  # # #   #    #   # #      #
# #   # # #  #  #   #  # # #   #  # #   # # #    #
#### ######  #      #  #   #   #  # #   # # #    #
# #       #  #  #   #  # # #   ## ####### # #    #
# ####### #### ##   #  # # #   #    #   # # #    #
# #    #  #     #   #  # # #   #    #   # # #    #
# #    #  ##### #####  # # #   #    #   # ##### ##
# #    #  #  #      #  # #     #    #   # # #    #
# #    #  #  ## #####  ### #####        # # #    #
#      #  #  #      #  #       #    #   # # #    #
# #    #  #  #  #   #  #    #  #    #   # # #    #
# #    #  #     #   #  #    #  #    #   # # #    #
# #    #  #  #  #      #    #  #    #   # # #    #
# #       #  #  #   #  #    #       #   # # #    #
########################### ####    #   # # #    #
#                              #    #   # # #    #
#                              #    #   # #      #
##################################################
