############################↑#####################
#                #    #                          #
#                #    #                          #
#                #    #                          #
#                #    #                          #
### ##############    ##################### ######
#              # #    # # #    #    #   #    # # #
#          #   # #    # # #    #    #   #      # #
#          #   #      # # #    #    #   #    # # #
######## ###   # #    #   #    #    #   #    # # #
#          #   # #    # # #    #    #   #    # # #
############## # #    # # #    #    #   #    # # #
#          #   # #    # # #    #    #   #    # # #
#  ####### #   # #    # #      #    #        # # #
#  # #     #   # #    # # #    #    #   #    # # #
#  # #         # #    # ### ####    #   #    # # #
#  # #     #   # #    # #    # #    #   #### ### #
#  # #### ##   # #    # #    # #    #   #    # # #
#  #       #   # #      #    # #    #   #    # # #
#  # #     #   # #    # #    # #    #   #    # # #
# ##########   # #    # #    # #    #   #    # # #
#    #   # #   # #    # #    # #    #   #      # #
#    #     #   # #    # #    # #    #   #    # # #
#    #   # #   # #    # #    # #        #    # # #
#        # #     #    # #    # #    ######## ### #
#    #   # #   # #    # #    # #    #  #         #
#    #   # #   # #    # #    #      #  # ####### #
#    #   # #   # #    # #      #    #       #  # #
#    #   # #   # #    # #    # #    #  #    #  # #
# ######## #   # #    # #    # #    #  #    #  # #
#        # #   # #    # #    # #    #  #    #  # #
### ################### #    # #    #  #    #  # #
#           # # #     # #    # #    #  #    #  # #
###### ######   #   # # #    # #    #  #       # #
#   #       # # #   # # ########    #  #    #  # #
#   ### ##### # #   # #      # #    #  #    #  # #
#   # #   # # #     # #      # #    #  #    #  # #
#   # #   # # #### ## ### #### #    #  #    #  # #
#   # #   # # #     # #      # #    #  #    #  # #
#   #     # # #     # #        #    #  #    #  # #
#   # #   # # #     # # #############  #    #  # #
#   # ##### # #     # #   #         #  #    #  # #
#   # #   # ### ##### #   #### ######### #########
#   # #   # #       # #     #       #            #
#   # #   # ## ########   #         #          # #
#   # #   # #         #   # #       #          # #
#     #               #   # #       #          # #
#   # #   # #         #   # ####### # ########## #
#   #     # #         #   # #       #          # #
###↓##############################################
