┌────────────┬──────────────────────────────────┐
┌────────────┬───────────────────────────────────┐                                                # 
#                                                #  
#                                                #     
#                                                #  
#                                                #     
#                                                #     
#                                                #     
#            #################                   #     
#            #               #                   #     
#            #               #                   #     
#            #               #                   #     
#            #               #                   #     
#            #               #                   #     
##############               #                   #     
#                            #                   #     
#                            #                   #     
#                            #                   #    
#                            #                   #     
#                            #                   #     
#                            #                   #     
#                                                #     
#                                                #     
#                                                #     
#                                                #     
#                                                #     
#                                                #     
#                                                #     
#                                                #     
#                                                #     
#                                                #     
#                                                #     
#                                                #     
#                                                #     
#                                                #     
#                                                #     
#                                                #     
#                                                #     
#                             #                  #     
###############################                  #     
#                                                #     
#                                                #     
#                                                #     
#                                                #     
#                                                #     
#                                                #                                                          
#                                                #     
#                                                #     
#                                                #     
##################################################