#↑################################################
#    #                      # #                  #
#    ######## ############### #                # #
#    #    #    #    #     # # #                # #
#    #    #    #    ##### # # ##### ############ #
#    #    #    #       #  # # #   # #          # #
#    #    #    #    #  #  # # #     ######## ### #
#    #    #    #    #  #  # # #   # #          # #
#    #         #    #  #  # # #   # #          # #
#    #    #    #    #  #  # # #   # #          # #
#         #    #    #  #  # # #   #            # #
#    #    #    #    #  #  # # #   #### ######### #
#    ### #######    #  #  # # #   #            # #
#    # #       #    #  #  # # ############ #######
#    # ### #####    #  #  # #    #    #          #
#    # #   #   #    #  #  # # #  #    ######## ###
#    #     #   #    #  #  # # #  #    # #      # #
#    # #   #        #  #  # # #  #      #        #
#    # #   #   #    #  #    # #       # ### #### #
#    # #       #    #  #  # # ###### ## #      # #
#    # #   #   #    #  #  # # #       #        # #
#    ######## #######  #  # # #       # #      # #
#    #              #  #  # # #       ####### ## #
#    #         #    #  #  # # #       #        # #
#    #         #    #     # ##### ################
#    #         #    #  #  # #                    #
#    ## ########    #  #  # # ################## #
#    #         #    #  #  #   #                  #
#    #### ################# # #                  #
#    #                    # # #                  #
#    ### #########################################
#    #                           #               #
#    ################# ############## ############
#    #            # #            #  #            #
#    ## ########### #            #  ##### ###### #
#    #          #   ## ###########  #   #      # #
#    #   ## ##### # #         #  #  #   #      # #
#    #   #      # # #            #      #      # #
#    #   #    # # # #         #  #  #   ###### # #
#    #   #    # # #           #  #  #          # #
#    #   #    # # # ####### ###  #  #   #      # #
#    #   #    # # # #         #  ######### ##### #
#    #   #    # # ############## #      #      # #
#    ######## ### #          #   ###### #### ### #
#    # #        # #          #   #  #          # #
#    #          # #                 #   #    # # #
#    # #          #          #   #  #   #    # # #
#    # #### ##### ######### ##   #      #    # # #
#    # #        # #          #   #  #   #    # # #
##########↓#######################################
